10
10
1 1
8 8
++++++++++
+000000000+
+0+++++++0+
+0+0000000+
+0+0000000+
+0+0+++++0+
+0+0+00000+
+0+0+0+++++
+0+0000000+
++++++++++