8
8
2 2
6 7
++++++++
+000000+
+00+0+0+
+0+0+0+0
+0+0+0+0
+0+0+0+0
+0+0+0+0
+00000+0
++++++++