10
10
0 0
9 9
++++++++++
0000000000
0+++++0000
0+0+0++++0
0+0+000+00
0+0+0++00+
0++000++0+
0++++++00+
0000000++0
0+++++++0+
++++++++++